IG_C_gene	IG
IG_C_pseudogene	IG
IG_D_gene	IG
IG_J_gene	IG
IG_J_pseudogene	IG
IG_V_gene	IG
IG_V_pseudogene	IG
lincRNA	lincRNA
miRNA	miRNA
miRNA_pseudogene	miRNA
misc_RNA	misc_RNA
misc_RNA_pseudogene	misc_RNA
Mt_rRNA	mitocondrial
Mt_tRNA	mitocondrial
Mt_tRNA_pseudogene	mitocondrial
polymorphic_pseudogene	pseudogene
processed_transcript	processed_transcript
protein_coding	protein_coding
pseudogene	pseudogene
rRNA	rRNA
rRNA_pseudogene	rRNA
scRNA_pseudogene	scRNA_pseudogene
snoRNA	snoRNA
snoRNA_pseudogene	snoRNA
snRNA	snRNA
snRNA_pseudogene	snRNA
TR_C_gene	TR
TR_J_gene	TR
tRNA_pseudogene	tRNA_pseudogene
TR_V_gene	TR
TR_V_pseudogene	TR
